2222222222222
0011111111100
0000333330000
0000004000000
0000000000000
0000000000000
0000000000000
0000000000000
0000000000000
1111100011111
5555500055555

1023201023201
0102010102010
2010102010102
3204023204023
2010102010102
0100010100010
1004033304001
1004033304001
0100010100010
2010102010102
3204023204023
2010102010102
0100010100010
1000001000001

1111211121111
1232100012321
1343103013431
1232100012321
1111211121111
1000100010001
1030103010301
1000100010001
1111211121111
1000100010001
1030103010301
1000100010001
1111211121111
0000000000000
